11111111
1P000101
100C1E11
1C000101
11111111
